#################
#...............#
#...#####....####
#...#####.......#
#............####
#...###.#.#.....#
#########.#####.#
#.........#.....#
#################
